time = 60
background_colour = (170, 179, 235)
text_colour = (255, 255, 255)
 - - - - - - - - - - - -
|S|                     |

| |                     |

| |                     |

| |                     |
   
| |                     |

| |                     |

| |                     |
   - - - - - - - - - - - 
|                 |   | |
 - - - - - - - - - -    
